d  ##### #  ###
 #     # ## #  
  ## #   #    #
#   ####   ####
   #     ###  #
## ####      ##
   ###    #####
 #   ## # #   #
 ## #   #   ###
###  #### #####
### ## #  ##  #
#   #  # ##  ##
  #   #     ### 
####  ## ## ###
#    ###  #   a