d      a#######
##    #########
###############
###############
###############
###############
###############
###############
###############
###############
###############
###############
###############
###############
###############